5
6
111111
100301
100001
102001
111111
