5
6
111111
100301
100001
120001
111111
